# dynamic map 8x12 with moving obstacles represented by 'M'
1 1 1 1 1 1 1 1 1 1 1 1
1 1 1 1 M 1 1 1 1 1 1 1
1 1 -1 1 1 1 1 1 1 1 1 1
1 1 1 1 1 1 1 -1 1 1 1 1
1 1 1 1 1 1 1 1 1 1 1 1
1 1 1 -1 1 1 1 1 1 1 1 1
1 1 1 1 1 1 1 1 1 1 1 1
1 1 1 1 1 1 1 1 1 1 1 1
